aidans	aidan
aidan's	aidan
alkeldas	alkelda
alkelda's	alkelda
alkmunds	alkmund
alkmund's	alkmund
andrews	andrew
andrew's	andrew
augustines	augustine
augustine's	augustine
baptists	baptist
baptist's	baptist
barnabass	barnabas
barnabas's	barnabas
bartholomews	bartholomew
bartholomew's	bartholomew
bartholomewes	bartholomew
catherines	catherine
catherine's	catherine
chads	chad
chad's	chad
christophers	christopher
christopher's	christopher
churchyard	church
graveyard	church
churchs	church
churches	church
cuthberts	cuthbert
cuthberts	cuthbert
cuthbert's	cuthbert
cuthbert's	cuthbert
edmunds	edmund
edmund's	edmund
emmanuels	emmanuel
emmanuel's	emmanuel
evangelists	evangelist
evangelist's	evangelist
georges	george
george's	george
helens	helen
helen's	helen
hildas	hilda
hilda's	hilda
jamess	james
james'	james
james's	james
johns	john
john's	john
johns	john
josephs	joseph
joseph's	joseph
lawrences	lawrence
lawence's	lawrence
lukes	luke
lukes	luke
luke's	luke
luke's	luke
magdalenes	magdalene
magdalene's	magdalene
margarets	margaret
margaret's	margaret
marks	mark
mark's	mark
martins	martin
martin's	martin
marys	mary
mary's	mary
mareys	mary
michaels	michael
michael's	michael
oswalds	oswald
oswald's	oswald
patricks	patrick
patrick's	patrick
peters	peter
peter's	peter
philips	philip
philip's	philip
richards	richard
richard's	richard
romalds	romald
romald's	romald
saviours	saviour
saviour's	saviour
souls	soul
soul's	soul
souls's	soul
saint	st
saints	st
saint's	st
saints's	st
stephens	stephen
stephen's	stephen
thomass	thomas
thomas'	thomas
thomas's	thomas
virgins	virgin
virgin's	virgin
wilfrids	wilfrid
wilfrid's	wilfrid